query_1_Walking.txt	Walking
query_1_Walking_Upstairs.txt	Walking_Upstairs
query_1_Walking_Downstairs.txt	Walking_Downstairs
query_1_Sitting.txt	Sitting
query_1_Standing.txt	Standing
query_1_Laying.txt	Laying
query_2_Walking.txt	Walking
query_2_Walking_Upstairs.txt	Walking_Upstairs
query_2_Walking_Downstairs.txt	Walking_Downstairs
query_2_Sitting.txt	Sitting
query_2_Standing.txt	Standing
query_2_Laying.txt	Laying
query_3_Walking.txt	Walking
query_3_Walking_Upstairs.txt	Walking_Upstairs
query_3_Walking_Downstairs.txt	Walking_Downstairs
query_3_Sitting.txt	Sitting
query_3_Standing.txt	Standing
query_3_Laying.txt	Laying
query_4_Walking.txt	Walking
query_4_Walking_Upstairs.txt	Walking_Upstairs
query_4_Walking_Downstairs.txt	Walking_Downstairs
query_4_Sitting.txt	Sitting
query_4_Standing.txt	Standing
query_4_Laying.txt	Laying
query_5_Walking.txt	Walking
query_5_Walking_Upstairs.txt	Walking_Upstairs
query_5_Walking_Downstairs.txt	Walking_Downstairs
query_5_Sitting.txt	Sitting
query_5_Standing.txt	Standing
query_5_Laying.txt	Laying
query_6_Walking.txt	Walking
query_6_Walking_Upstairs.txt	Walking_Upstairs
query_6_Walking_Downstairs.txt	Walking_Downstairs
query_6_Sitting.txt	Sitting
query_6_Standing.txt	Standing
query_6_Laying.txt	Laying
query_7_Walking.txt	Walking
query_7_Walking_Upstairs.txt	Walking_Upstairs
query_7_Walking_Downstairs.txt	Walking_Downstairs
query_7_Sitting.txt	Sitting
query_7_Standing.txt	Standing
query_7_Laying.txt	Laying
query_8_Walking.txt	Walking
query_8_Walking_Upstairs.txt	Walking_Upstairs
query_8_Walking_Downstairs.txt	Walking_Downstairs
query_8_Sitting.txt	Sitting
query_8_Standing.txt	Standing
query_8_Laying.txt	Laying
query_9_Walking.txt	Walking
query_9_Walking_Upstairs.txt	Walking_Upstairs
query_9_Walking_Downstairs.txt	Walking_Downstairs
query_9_Sitting.txt	Sitting
query_9_Standing.txt	Standing
query_9_Laying.txt	Laying
query_10_Walking.txt	Walking
query_10_Walking_Upstairs.txt	Walking_Upstairs
query_10_Walking_Downstairs.txt	Walking_Downstairs
query_10_Sitting.txt	Sitting
query_10_Standing.txt	Standing
query_10_Laying.txt	Laying
query_11_Walking.txt	Walking
query_11_Walking_Upstairs.txt	Walking_Upstairs
query_11_Walking_Downstairs.txt	Walking_Downstairs
query_11_Sitting.txt	Sitting
query_11_Standing.txt	Standing
query_11_Laying.txt	Laying
query_12_Walking.txt	Walking
query_12_Walking_Upstairs.txt	Walking_Upstairs
query_12_Walking_Downstairs.txt	Walking_Downstairs
query_12_Sitting.txt	Sitting
query_12_Standing.txt	Standing
query_12_Laying.txt	Laying
query_13_Walking.txt	Walking
query_13_Walking_Upstairs.txt	Walking_Upstairs
query_13_Walking_Downstairs.txt	Walking_Downstairs
query_13_Sitting.txt	Sitting
query_13_Standing.txt	Standing
query_13_Laying.txt	Laying
query_14_Walking.txt	Walking
query_14_Walking_Upstairs.txt	Walking_Upstairs
query_14_Walking_Downstairs.txt	Walking_Downstairs
query_14_Sitting.txt	Sitting
query_14_Standing.txt	Standing
query_14_Laying.txt	Laying
query_15_Walking.txt	Walking
query_15_Walking_Upstairs.txt	Walking_Upstairs
query_15_Walking_Downstairs.txt	Walking_Downstairs
query_15_Sitting.txt	Sitting
query_15_Standing.txt	Standing
query_15_Laying.txt	Laying
query_16_Walking.txt	Walking
query_16_Walking_Upstairs.txt	Walking_Upstairs
query_16_Walking_Downstairs.txt	Walking_Downstairs
query_16_Sitting.txt	Sitting
query_16_Standing.txt	Standing
query_16_Laying.txt	Laying
query_17_Walking.txt	Walking
query_17_Walking_Upstairs.txt	Walking_Upstairs
query_17_Walking_Downstairs.txt	Walking_Downstairs
query_17_Sitting.txt	Sitting
query_17_Standing.txt	Standing
query_17_Laying.txt	Laying
query_18_Walking.txt	Walking
query_18_Walking_Upstairs.txt	Walking_Upstairs
query_18_Walking_Downstairs.txt	Walking_Downstairs
query_18_Sitting.txt	Sitting
query_18_Standing.txt	Standing
query_18_Laying.txt	Laying
query_19_Walking.txt	Walking
query_19_Walking_Upstairs.txt	Walking_Upstairs
query_19_Walking_Downstairs.txt	Walking_Downstairs
query_19_Sitting.txt	Sitting
query_19_Standing.txt	Standing
query_19_Laying.txt	Laying
query_20_Walking.txt	Walking
query_20_Walking_Upstairs.txt	Walking_Upstairs
query_20_Walking_Downstairs.txt	Walking_Downstairs
query_20_Sitting.txt	Sitting
query_20_Standing.txt	Standing
query_20_Laying.txt	Laying
query_21_Walking.txt	Walking
query_21_Walking_Upstairs.txt	Walking_Upstairs
query_21_Walking_Downstairs.txt	Walking_Downstairs
query_21_Sitting.txt	Sitting
query_21_Standing.txt	Standing
query_21_Laying.txt	Laying
query_22_Walking.txt	Walking
query_22_Walking_Upstairs.txt	Walking_Upstairs
query_22_Walking_Downstairs.txt	Walking_Downstairs
query_22_Sitting.txt	Sitting
query_22_Standing.txt	Standing
query_22_Laying.txt	Laying
query_23_Walking.txt	Walking
query_23_Walking_Upstairs.txt	Walking_Upstairs
query_23_Walking_Downstairs.txt	Walking_Downstairs
query_23_Sitting.txt	Sitting
query_23_Standing.txt	Standing
query_23_Laying.txt	Laying
query_24_Walking.txt	Walking
query_24_Walking_Upstairs.txt	Walking_Upstairs
query_24_Walking_Downstairs.txt	Walking_Downstairs
query_24_Sitting.txt	Sitting
query_24_Standing.txt	Standing
query_24_Laying.txt	Laying
query_25_Walking.txt	Walking
query_25_Walking_Upstairs.txt	Walking_Upstairs
query_25_Walking_Downstairs.txt	Walking_Downstairs
query_25_Sitting.txt	Sitting
query_25_Standing.txt	Standing
query_25_Laying.txt	Laying
query_26_Walking.txt	Walking
query_26_Walking_Upstairs.txt	Walking_Upstairs
query_26_Walking_Downstairs.txt	Walking_Downstairs
query_26_Sitting.txt	Sitting
query_26_Standing.txt	Standing
query_26_Laying.txt	Laying
query_27_Walking.txt	Walking
query_27_Walking_Upstairs.txt	Walking_Upstairs
query_27_Walking_Downstairs.txt	Walking_Downstairs
query_27_Sitting.txt	Sitting
query_27_Standing.txt	Standing
query_27_Laying.txt	Laying
query_28_Walking.txt	Walking
query_28_Walking_Upstairs.txt	Walking_Upstairs
query_28_Walking_Downstairs.txt	Walking_Downstairs
query_28_Sitting.txt	Sitting
query_28_Standing.txt	Standing
query_28_Laying.txt	Laying
query_29_Walking.txt	Walking
query_29_Walking_Upstairs.txt	Walking_Upstairs
query_29_Walking_Downstairs.txt	Walking_Downstairs
query_29_Sitting.txt	Sitting
query_29_Standing.txt	Standing
query_29_Laying.txt	Laying
query_30_Walking.txt	Walking
query_30_Walking_Upstairs.txt	Walking_Upstairs
query_30_Walking_Downstairs.txt	Walking_Downstairs
query_30_Sitting.txt	Sitting
query_30_Standing.txt	Standing
query_30_Laying.txt	Laying